#####################
#   #############   #
#  ########## ####  #
# #### ####### #### #
########## ## #######
### ## ######### # ##
############# #######
## ###### ####### ###
####### # # ###### ##
###### #### ### #####
### ##### ######### #
###### # ## ### ### #
## ### ### ######## #
### ##### # ### #####
## ### #### #########
## #### #### ### ####
######## #### #######
# ### #### ##### ## #
#  ##### ## ######  #
#   # ### #### ##   #
#####################
