########   ##########
#   ############   ##
#  ######### ####  ##
# #### ###### #### ##
########## # ########
### ## ######## # ###
## ###### ###### ####
#####################
#####################
#####################
########## ##########
#####################
#####################
#####################
## ### #### #########
## #### ####### #####
######## ### ########
# ### #### #### ## ##
#  ##### ## #####  ##
#   # ### ### ##   ##
#####################